     
     
     
     
     
     ====================
     =)              v  =
     =   d              =
     = ------------     =
     =                  =
     =   =bbbbbbbb=     =
     =a  ==========  <  =
     ====================
     
