     
     
     
     
     
     =======================
     =)                 v  =
     =   d                 =
     = ------------        =
     =                     =
     =   =bbbbbbbbb        =
     =a  ==========     <  =
     =======================
     
