================================
=                              =
= d                            =
=))))))))))))                  =
=                              =
=                              =
=                              =
=                              =
=                              =
=                              =
=                              =
=                              =
=                              =
=                              =
=                              =
=                              =
=                              =
=                              =
=                              =
=                              =
=                              =
=                              =
=                              =
================================
