********************************
*                              *
*                              *
*                              *
*=)   =                        *
*  d                           *
*  =                           *
*   -------------------    <   *
*                          <   *
*                          <   *
*  >    -------------------    *
*  >                           *
*  >                        ****
*   ---------------------*******
********************************
*************************** ****
*************************** ****
**************************   ***
************************** a ***
********************************
********************************
********************************
********************************
********************************
