================================
=                              =
=                              =
=                              =
= )  =                         =
=  d                           =
=  =                           =
=   *******************    =   =
=                          =   =
=                          =   =
=  =    *****************==    =
=  =                           =
=  =                        =  =
=   ==******************    =  =
=                       =   =  =
=                       =   =  =
=                       =   =  =
=                       =   =  =
=                       = a =  =
=                        ***   =
=                              =
=                              =
=                              =
================================
