================================
=                              =
=                              =
=                *             =
=                *             =
===d             *             =
====*********    *             =
=                *             =
=                *             =
=                *             =
=                *             =
=                *             =
=                *             =
=                *             =
=                *             =
=                *             =
=   **************             =
=                              =
=                              =
=                              =
=                              =
=                              =
=                              =
================================
