================================
=        u        u      =======
=                        =======
= d                      =======
=                        =======
=)   n       n        n        =
======================== =======
======================== =======
========                 =======
========                 =======
========                 =======
========   ============= =======
========   ============= =======
========              == =======
========              ==v=======
========              == =======
========              == =======
========              == =======
========              == =======
========                   =====
========a                  <====
==========             = == ====
===========^=========== >  ^====
================================
