================================
==                             =
==                             =
==                             =
==                             =
=        d   <                 =
==       =                     =
==  >                          =
==  >                          =
==  >                        = =
==  >                          =
==              =              =
==                             =               
==   >                 a       <
==      ====> > > =    =====   = 
==                             =
==                =            =
==                 =       =   =
==                         =   =
==                             =
==                >           ==
=============================n==
============================= ==                              
================================
