================================
==                             =
==                             =
==                             =
==                             =
=        d   <                 =
==       =                     =
==  >                          =
==  >                          =
==  >                        = =
==  >                          =
==              =              =
==                           n =               
==   >                 a       <
==      ====> > > =    =====   = 
==       ===      =            =
==        ==      =            =
==         =      ==       =   =
==                ==       =   =
==                ===          =
==               ===>         ==
==               ============ ==
==                =========== ==                              
==                ==============
