

          > d a
    =   =   ===   =   =   =
    =   =  =   =  =   =   =
    =   =  =   =  =   =   =
     = =   =   =   = =    =
      =    =====    =     =
      =    =   =    =      
      =    =   =    =     =
      =    =   =    =     =
