
         ===
     ===== =========
    =               =
    =   > ^ v d     =
    =    === ===    =
    =      ===      =
    =               =
    =            a  =
     ===============
