================================
=                              =
=             d                =
=          *******             =
=                              =
=                              =
=                  a           =
=     ****** ) ******          =
=                              =
=                              =
=                              =
=                              =
=                              =
=                              =
=                              =
=                              =
=                              =
=                              =
=                              =
=                              =
=                              =
=                              =
=                              =
================================
