================================
=                              =
=  >      =                    =
=    d    v                    =
=  =====   =====               =
=       ***                    =
=       ***                    =
=                              =
=       aaa                    =
=      =====                   =
=                              =
=                              =
=                              =
=                              =
=                              =
=                              =
=                              =
=                              =
=                              =
=                              =
=                              =
=                              =
=                              =
================================
