================================
==                             =
==                             =
==                             =
==                             =
=        d   <                 =
==       =                     =
==  >                          =
==  >                          =
==  >                        = =
==  >                          =
==              =              =
==                             =               
==   >                 a       <
==      ====> > > =    =====   = 
==       ===                   =
==        ==      =            =
==        ==       =       =   =
==        ==               =   =
==        ==                   =
==        ==      >           ==
==        ===================n==
==        =================== ==                              
==        ======================
