

     ===============
    =               =
    =   >  d        =
    =    =======    =
    =               =
    =               =
    =            a  =
     ===============
