================================
=                              =
=                              =
=                              =
=                              =
=  >                 a         =
=    =================         =
=                              =
=                              =
=                              =
=                              =
=                              =
=                              =
=                              =
=                              =
=                              =
=                              =
=                              =
=                              =
=                              =
=   d                          =
=   ^                          =
=                              =
================================
