



   
            ===
        ===== =========
       =               =
       =   > ^ v d     =
       =    === ====   =
       =      ===      =
       =               =
       =             a =
        ===============
